NO                   ./textures/wall1.xpm
SO textures/wall2.xpm
EA ./textures/wall3.xpm
WE                 ./textures/wall4.xpm


F     0000000000000001,      76     ,       75
     C 42,141,255




111111111111111111111
101 10000001   10N001
100100000000111000001
10000000000000000001
100000000000000000001
100000000000000000001
11111111111111111111
