NO                   ./textures/wall1.xpm
SO textures/wall2.xpm               
EA ./textures/wall3.xpm
WE                 ./textures/wall4.xpm


F     80,      76     ,       75
     C 42,141,255




11111111111111111111
101 10000001 10000001
100100000000100000001
10000000000000000001
100000000000000000001
1000000000N0000000001
11111111111111111111
