NO                   ./path_to_the_north_texture.xpm
SO ./path_to_the_south_texture.xpm
EA ./path_to_the_east_texture.xpm
WE ./path_to_the_west_texture.xpm


F     220,      100,       243
C 225,30,0




1111111111
1111111111
     11111
     11111
     111111111111
     111000000111
     11000000N0011
     1111111111111111
     111111111111111111111111111
