NO                   ./textures/wall1.xpm
SO textures/wall2.xpm
EA ./textures/wall3.xpm
WE ./textures/wall4.xpm


F     80,      76,       75
C 42,141,255




11111111111111111111
10000000001100000001
10110000011100000001
10010000000000000001
11111111101100000111
10000000001100000111
10000000001101010111
10000000000000000001
10000000001100000001
10000000001100N00001
11111111111111111111
